NO
SO

WE

EA
F 0,32,32





C 32,32,32


1111111111111
100000N000001
1000000000001
1111111111111