NO ./fdsafdsasdfafds
SO ./fdsafdsasdfafds

WE ./fdsafdsasdfafds

EA ./fdsafdsasdfafds
F ff,ff,ff





C xx,xx,xx


1111111111111
100000N000001
1000000000001
1111111111111