NO ./fdsafdsasdfafds
SO ./fdsafdsasdfafds

WE ./fdsafdsasdfafds

EA ./fdsafdsasdfafds
F 0,32,32





C 32,32,32



1D1111111111111111111111111111111111
100000000010000000000000000000000001
100000000010000000000000000000000001
100000011100000000000000000100000001
1000N00DDD00000000000000001 10000001
100000011100000000000000000110000001
100000000000000000000000000000000001
100000000000000000000000000000000001
111111111111111111111111111111111111